word	phon
'ave	'{v
'ere	'7R
a	@
aah	'#
aah-ooh	'#-'u
able	'1-bP
about	@-'b6t
abubbies	@-'bV-bIz
accidents	'{k-sI-d@nts
ache	'1k
act	'{kt
addict	'{-dIkt
aeroplane	'8-r@-pl1n
afraid	@-'fr1d
after	'#f-t@R
afternoon	'#f-t@-'nun
again	@-'gEn
ahead	@-'hEd
ahhbo	'#-b5
ahuh	@-'h5
ain't	'1nt
air	'8R
alan	'{-lIn
all	'$l
allowed	@-'l6d
alone	@-'l5n
along	@-'lQN
already	$l-'rE-dI
alright	$l-'r2t
also	'$l-s5
always	'$l-w1z
am	'{m
an	@n
and	@nd
angry	'{N-grI
annoy	@-'n4
annoyed	@-'n4d
annoying	@-'n4-IN
another	@-'nV-D@R
ant	'{nt
anthony	'{n-T5-ni
any	'E-nI
anybody	'E-nI-"bQ-dI
anymore	E-nI-'m$R
anyone	'E-nI-wVn
anything	'E-nI-TIN
anywhere	'E-nI-w8R
apple	'{-pP
are	'#R
aren't	'#nt
arm	'#m
armie	'#-mI
armies	'#-mIz
arms	'#mz
around	@-'r6nd
arrows	'{-r5z
arsies	'#-siz
as	@z
ask	'#sk
asking	'#-skIN
asleep	@-'slip
asleepies	@-'sli-piz
astra	'{s-tr@
astra's	'{s-tr@z
at	@t
atchoo	@-'Ju
atishoo	@-'tI-Su
attached	@-'t{Jt
attention	@-'tEn-SH
auntie	'#n-tI
awake	@-'w1k
away	@-'w1
awful	'$-fUl
awfully	'$-fU-lI
awkward	'$-kw@d
ayo	'#-j5
babba	'b#-b#
babe	'b1b
babies	'b1-bIz
baby	'b1-bI
baby's	'b1-bIz
babygro	'b1-bI-'gr5
back	'b{k
bacon	'b1-k@n
bad	'b{d
bald	'b$ld
ball	'b$l
ballet	'b{-l1
balls	'b$lz
banbury	'b{n-bV-rI
bandy	'b{n-dI
banged	'b{Nd
bare	'b8R
bash	'b{S
bashing	'b{-SIN
bath	'b#T
bathing	'b1-DIN
bathroom	'b#T-rUm
baths	'b#Ts
bathy	'b#-TI
batman	'b{t-m@n
baxter	'b{k-st@R
be	'bi
beady	'bi-dI
bear	'b8R
bear's	'b8z
bears	'b8z
beat	'bit
beautiful	'bju-t@-fUl
because	bI-'kQz
bed	'bEd
bedtime	'bEd-t2m
beebo	'bi-b5
been	'bin
beep	'bip
before	bI-'f$R
begging	'bE-gIN
being	'bi-IN
believe	bI-'liv
believed	bI-'livd
bell	'bEl
belly	'bE-lI
belong	bI-'lQN
below	bI-'l5
bend	'bEnd
beside	bI-'s2d
best	'bEst
bet	'bEt
better	'bE-t@R
bib	'bIb
bicycle	'b2-sI-kP
big	'bIg
bigger	'bI-g@R
biggest	'bI-gIst
bin	'bIn
bird	'b3d
birds	'b3dz
birthday	'b3T-d1
biscuit's	'bI-skIts
bit	'bIt
bite	'b2t
biting	'b2-tIN
bits	'bIts
bitter	'bI-t@R
black	'bl{k
blankets	'bl{N-kIts
bless	'blEs
blimey	'bl2-mI
blinds	'bl2ndz
blisters	'blI-st@z
blooming	'blu-mIN
blouse	'bl6z
blow	'bl5
blowing	'bl5-IN
blue	'blu
bo	'b5
bo's	'b5z
bo-byes	'b5-'b1z
bobo's	'b5-b5z
body	'bQ-dI
boiling	'b4-lIN
bone	'b5n
bones	'b5nz
bonnet	'bQ-nIt
boo	'bu
boon	'bun
bop	'bQp
bored	'b$d
boring	'b$-rIN
borks	'b$ks
bot	'bQt
bot's	'bQts
both	'b5T
bother	'bQ-D@R
bothered	'bQ-D@d
bottle	'bQ-tP
bottom	'bQ-t@m
bottoms	'bQ-t@mz
botty	'bQ-tI
bought	'b$t
bounce	'b6ns
bouncie	'b6n-sI
bouncing	'b6n-sIN
bowl	'b5l
boy	'b4
boys	'b4z
breakable	'br1-k@-bP
breakfast	'brEk-f@st
breathing	'bri-DIN
bright	'br2t
bring	'brIN
brings	'brINz
brothers	'brV-D@z
brought	'br$t
brown	'br6n
brush	'brVS
brushed	'brVSt
bubble	'bV-bP
bubbles	'bV-bPz
bubbly	'bV-blI
bucket	'bV-kIt
bucky	'bV-kI
bum	'bVm
bump	'bVmp
bunny	'bV-nI
burp	'b3p
burping	'b3-pIN
burps	'b3ps
busby	'bVz-bI
business	'bIz-nIs
busy	'bI-zI
but	'bVt
butterfly	'bV-t@-fl2
button	'bV-tH
by	'b2
bye	'b2
bye-bye	"b2-'b2
c'mon	k@-'mQn
cable	'k1-bP
cake	'k1k
cakes	'k1ks
called	'k$ld
calm	'k#m
came	'k1m
camera	'k{-m@-r@
can	k@n
can't	'k#nt
car	'k#R
card	'k#d
cardigan	'k#-dI-g@n
care	'k8R
careful	'k8-fUl
cares	'k8z
carpet	'k#-pIt
carry	'k{-rI
carrycot	'k{-rI-kQt
carrying	'k{-rI-IN
cartoon	k#-'tun
castle	'k#-sP
castor	'k#-st@R
cat	'k{t
cats	'k{ts
caught	'k$t
cause	k@z
cement	sI-'mEnt
center	'sEn-t@R
certain	's3-tH
cha	J@
chair	'J8R
chair's	'J8z
chance	'J#ns
change	'J1n_
changed	'J1n_d
changing	'J1n-_IN
charles	'J#lz
cheek	'Jik
cheeks	'Jiks
cheeky	'Ji-kI
chew	'Ju
chewin'	'Ju-In
chewing	'Ju-IN
chicken	'JI-kIn
chilly	'JI-lI
chime	'J2m
chin	'JIn
chinny	'JI-nI
chinywinywiny	'JI-nI-'wI-nI
choice	'J4s
choke	'J5k
choked	'J5kt
chops	'JQps
chou	'J6
chris	'krIs
christ	'kr2st
christopher	'krIs-t@-f@r
christopher's	'krIs-t@-f@rz
chubby	'JV-bI
chuckles	'JV-kPz
chucky	'JV-kI
church	'J3J
clap	'kl{p
clark	'kl#k
clean	'klin
clever	'klE-v@R
clevey	'klE-vI
climb	'kl2m
climbing	'kl2-mIN
clinic	'klI-nIk
closed	'kl5zd
clothes	'kl5Dz
cob	'kQb
coffee	'kQ-fI
cold	'k5ld
colors	'kV-l@z
come	'kVm
comes	'kVmz
comin	'kV-mIn
coming	'kV-mIN
compete	k@m-'pit
complain	k@m-'pl1n
complaining	k@m-'pl1-nIN
complains	k@m-'pl1nz
complaints	k@m-'pl1nts
concentrate	'kQn-s@n-tr1t
concentrating	'kQn-s@n-tr1-tIN
conditions	k@n-'dI-SHz
conduct	k@n-'dVkt
confused	k@n-'fjuzd
contact	'kQn-t{kt
contemplating	'kQn-tEm-pl1-tIN
cooing	'ku-IN
cook	'kUk
cooking	'kU-kIN
copying	'kQ-pI-IN
cor	'k$R
cos	k@z
cosy	'k5-zI
cot	'kQt
cough	'kQf
coughs	'kQfs
could	k@d
countrymen	'kVn-trI-m@n
couple	'kV-pP
course	'k$s
cover	'kV-v@R
covered	'kV-v@d
coy	'k4
cradle	'kr1-dP
crawl	'kr$l
crawling	'kr$-lIN
cream	'krim
creamy	'kri-mI
crease	'kris
cricket	'krI-kIt
critical	'krI-tI-kP
crocodile	'krQ-k@-d2l
crocodile's	'krQ-k@-d2lz
crocodiles	'krQ-k@-d2lz
cross	'krQs
crosspatch	'krQs-p{J
cruel	'kr9l
crumbs	'krVmz
crunch	'krVnJ
cry	'kr2
crying	'kr2-IN
cuddle	'kV-dP
cup	'kVp
cupboard	'kV-b@d
cuppa	'kV-p@
cups	'kVps
cupsy	'kVp-sI
curlies	'k3-lIz
curls	'k3lz
curly	'k3-lI
curtains	'k3-tHz
curtsy	'k3t-sI
cut	'kVt
cycling	's2-klIN
d'you	'djU
dad	'd{d
dad's	'd{dz
daddies	'd{-dIz
daddy	'd{-dI
daddy's	'd{-dIz
daft	'd#ft
daisy	'd1-zI
dance	'd#ns
dancer	'd#n-s@R
dancing	'd#n-sIN
danish	'd1-nIS
dark	'd#k
darling	'd#-lIN
day	'd1
dead	'dEd
dear	'd7R
dearie	'd7-rI
dearier	'd7-r7R
deborah	'dE-b@-r@
debra	'dE-br@
decided	dI-'s2-dId
dee	'di
deep	'dip
definitely	'dE-fI-nIt-lI
delitt	d@-'lIt
deserves	dI-'z3vz
desperately	'dE-sp@-r@t-lI
dessert	dI-'z3t
did	'dId
didn't	'dI-dHt
difference	'dI-fr@ns
different	'dI-fr@nt
difficult	'dI-fI-k@lt
din	'dIn
din-dins	'dIn-dInz
dinner	'dI-n@R
dinners	'dI-n@z
dins	'dInz
dirty	'd3-tI
disagreement	"dIs-@-'gri-m@nt
disco	'dI-sk5
dishes	'dI-SIz
distract	dI-'str{kt
distracting	dI-'str{k-tIN
disturbing	dI-'st3-bIN
dived	'd2vd
do	'du
doctors	'dQk-t@z
does	'dVz
doesn't	'dV-zHt
doin	'du-In
doing	'du-IN
dollop	'dQ-l@p
dolly	'dQ-lI
dolly's	'dQ-lIz
don't	'd5nt
donald	'dQn-n@ld
done	'dVn
door	'd$R
door's	'd$z
doors	'd$z
doot	'dut
down	'd6n
downstairs	"d6n-'st8z
draw	'dr$
drawers	'dr$z
dreadful	'drEd-fUl
dream	'drim
dreaming	'dri-mIN
dress	'drEs
dressed	'drEst
dressing	'drE-sIN
dribbles	'drI-bPz
dribbling	'drI-blIN
dribbly	'drI-blI
dried	'dr2d
drink	'drINk
drinkee	'drIN-kI
drinkies	'drIN-kIz
drinking	'drIN-kIN
drinks	'drINks
drip	'drIp
dripping	'drI-pIN
drips	'drIps
drop	'drQp
dropped	'drQpt
drunk	'drVNk
drunkard	'drVN-k@d
dry	'dr2
dub	'dVb
duck	'dVk
ducks	'dVks
duh	'dV
dummy	'dV-mI
dumpling	'dVm-plIN
during	'dj9-rIN
dusty	'dV-stI
dying	'd2-IN
each	'iJ
ear	'7R
earlier	'3-l7R
early	'3-lI
ears	'7z
easier	'i-z7R
easy	'i-zI
eat	'it
eaten	'i-tH
eating	'i-tIN
edge	'E_
egg	'Eg
eh	'1
either	'2-D@R
elaine	i-'l1n
electrocute	I-'lEk-tr@-kjut
else	'Els
end	'End
energy	'E-n@-_I
enjoy	In-'_4
enjoyed	In-'_4d
enjoying	In-'_4-IN
enough	I-'nVf
er	'3
especially	I-'spE-S@-lI
even	'i-vH
evening	'i-vH-IN
ever	'E-v@R
every	'E-vrI
everybody	'E-vrI-"bQ-dI
everything	'E-vrI-TIN
everywhere	'E-vrI-w8R
except	Ik-'sEpt
excited	Ik-'s2-tId
exciting	Ik-'s2-tIN
excuse	Ik-'skjuz
exercises	'Ek-s@-s2-zIz
expect	Ik-'spEkt
extras	'Ek-str@z
eye	'2
eyelashes	'2-l{-SIz
eyes	'2z
face	'f1s
faced	'f1st
faces	'f1-sIz
facies	'f1-sIz
fair	'f8R
faithful	'f1T-fUl
fall	'f$l
fallen	'f$-l@n
falling	'f$-lIN
fancy	'f{n-sI
far	'f#R
fascinated	'f{-sI-n1-tId
fast	'f#st
fat	'f{t
fatty	'f{-tI
fault	'f$lt
favorite	'f1-v@-rIt
feather	'fE-D@R
fed	'fEd
feed	'fid
feeding	'fi-dIN
feel	'fil
feeling	'fi-lIN
feels	'filz
feet	'fit
felix	'fi-lIks
fever	'fi-v@R
fierce	'f7s
fight	'f2t
fighting	'f2-tIN
fill	'fIl
filled	'fIld
filling	'fI-lIN
filling's	'fI-lINz
film	'fIlm
films	'fIlmz
filthy	'fIl-TI
find	'f2nd
fine	'f2n
finger	'fIN-g@R
fingers	'fIN-g@z
finish	'fI-nIS
finished	'fI-nISt
finishes	'fI-nI-SIz
fire	'f2-@R
first	'f3st
fishes	'fI-SIz
fisties	'fI-stIz
fit	'fIt
fits	'fIts
five	'f2v
flavor	'fl1-v@R
floating	'fl5-tIN
floor	'fl$R
floppy	'flQ-pI
flour	'fl6-@R
flowers	'fl6-@z
flown	'fl5n
fluffy	'flV-fI
fly	'fl2
flying	'fl2-IN
fold	'f5ld
food	'fud
foot	'fUt
football	'fUt-b$l
for	f@
forget	f@-'gEt
forgiven	f@-'gI-vH
forthcoming	"f$T-'kV-mIN
fourteen	"f$-'tin
fresh	'frES
friend	'frEnd
friends	'frEndz
fright	'fr2t
frighten	'fr2-tH
froggy	'frQ-gI
from	frQm
front	'frVnt
frothing	'frQ-TIN
frustrating	frV-'str1-tIN
full	'fUl
fun	'fVn
funnier	'fV-n7R
funny	'fV-nI
furry	'f3-rI
further	'f3-D@R
fussing	'fV-sIN
fuzzy	'fV-zI
gained	'g1nd
gam	'g{m
game	'g1m
games	'g1mz
garden	'g#-dH
gargler	'g#-gl@R
gary	'd8-rI
gave	'g1v
gel	'_El
gentle	'_En-tP
get	'gEt
gets	'gEts
gettin	'gE-tIn
getting	'gE-tIN
giddy	'gI-dI
gillian	'_I-lj@n
gillian's	'_I-lj@nz
girl	'g3l
girl's	'g3lz
girlie	'g3-lI
girls	'g3lz
give	'gIv
given	'gI-vH
giving	'gI-vIN
glad	'gl{d
glass	'gl#s
glimpse	'glImps
globe	'gl5b
glove	'glVv
gluey	'glu-I
go	'g5
gobble	'gQ-bP
god	'gQd
goes	'g5z
goin	'g5-In
going	'g5-IN
golden	'g5l-d@n
gone	'gQn
gonna	'gQ-n@
good	'gUd
goodbye	"gUd-'b2
goodies	'gU-dIz
goodness	'gUd-nIs
goose	'gus
gorgeous	'g$-_@s
gosh	'gQS
got	'gQt
gotta	'gQ-t@
gou	'g6
gown	'g6n
grab	'gr{b
gracious	'gr1-S@s
granddad	'gr{n-d{d
grandma	'gr{n-m#
grease	'griz
great	'gr1t
greedy	'gri-dI
grip	'grIp
grotty	'grQ-tI
grow	'gr5
grown	'gr5n
growth	'gr5T
grub	'grVb
grubby	'grV-bI
grumpy	'grVm-pI
grunt	'grVnt
grunting	'grVn-tIN
gums	'gVmz
guts	'gVts
guy	'g2
ha	'h#
had	'h{d
hadn't	'h{-dHt
hair	'h8R
half	'h#f
hand	'h{nd
handies	'h{n-dIz
hands	'h{ndz
handy	'h{n-dI
hang	'h{N
hanging	'h{-NIN
hanky	'h{N-kI
hannah	'h{-n@
hannah's	'h{-n@z
happen	'h{-p@n
happened	'h{-p@nd
happening	'h{-p@-nIN
happy	'h{-pI
hard	'h#d
has	'h{z
hasn't	'h{-zHt
hassles	'h{-sPz
hat	'h{t
have	'h{v
haven't	'h{-vHt
having	'h{-vIN
hay	'h1
he	'hi
he'll	'hil
he's	'hiz
head	'hEd
heads	'hEdz
heady	'hE-dI
health	'hElT
hear	'h7R
heavens	'hE-vHz
heavily	'hE-vI-lI
heavy	'hE-vI
heehee	'hi-'hi
hello	h@-'l5
help	'hElp
helping	'hEl-pIN
helps	'hElps
her	h3R
here	'h7R
here's	'h7z
hey	'h1
hey-ya	'h1-'jQ
hi	'h2
hiccup	'hI-kVp
hiccups	'hI-kVps
hick	'hIk
hickies	'hI-kIz
hidden	'hI-dH
hide	'h2d
hiding	'h2-dIN
high	'h2
hilda	'hIl-d@
him	hIm
his	hIz
hit	'hIt
hmm	'hF
hmm-hmm	'hF-'hF
ho	'h5
hoi	'b4
hold	'h5ld
holding	'h5l-dIN
hole	'h5l
holes	'h5lz
home	'h5m
honest	'Q-nIst
hop	'hQp
hope	'h5p
hopeless	'h5p-lIs
hoping	'h5-pIN
horny	'h$-nI
horrible	'hQ-r@-bP
horror	'hQ-r@R
hot	'hQt
hour	'6-@R
house	'h6s
how	'h6
how'd	'h6d
how's	'h6z
huge	'hju_
huh	'hV
hungry	'hVN-grI
hurry	'hV-rI
hurt	'h3t
i	'2
i'd	'2d
i'll	'2l
i'm	'2m
i've	'2v
ideas	2-'d7z
if	If
in	'In
in't	'Int
indian	'In-dj@n
inside	"In-'s2d
inspect	In-'spEkt
instead	In-'stEd
insult	In-'sVlt
interest	'In-tr@st
interested	'In-tr@-stId
interesting	'In-tr@-stIN
into	'In-tu
iray	'2-r1
iron	'2-@n
ironing	'2-@-nIN
is	'Iz
isn't	'I-zHt
it	It
it'll	'I-tP
it's	'Its
its	'Its
jacket	'_{-kIt
jamas	'_#-m@z
jiggle	'_I-gP
jiggled	'_I-gPd
job	'_Qb
johnson's	'_Qn-sHz
join	'_4n
joke	'_5k
joseph	'_5-sEf
joseph's	'_5-sEfs
journey	'_3-nI
juice	'_us
julie	'_u-lI
jump	'_Vmp
jumper	'_Vm-p@R
jumping	'_Vm-pIN
just	'_Vst
jutting	'_V-tIN
keen	'kin
keep	'kip
keeping	'ki-pIN
keeps	'kips
keith	'kiT
kettle	'kE-tP
kick	'kIk
kicked	'kIkt
kickello	kI-'kE-l5
kicking	'kI-kIN
kidding	'kI-dIN
kidney	'kId-nI
killing	'kI-lIN
kind	'k2nd
king	'kIN
kiss	'kIs
kitchen	'kI-JIn
kittens	'kI-tHz
kitty	'kI-tI
knacks	'n{ks
knee	'ni
knees	'niz
knew	'nju
knick	'nIk
knicker	'nI-k@
knock	'nQk
knockers	'nQ-k@z
knot	'nQt
know	'n5
knows	'n5z
knuckles	'nV-kPz
lad	'l{d
lady	'l1-dI
lambchahhh	'l{m-JQ
lambchop	'l{m-JQp
lambchop's	'l{m-JQps
lambs	'l{mz
lard	'l#d
last	'l#st
late	'l1t
laugh	'l#f
laughing	'l#-fIN
laughs	'l#fs
learnt	'l3nt
least	'list
leave	'liv
leaving	'li-vIN
left	'lEft
leg	'lEg
leggies	'lE-gIz
leggy	'lE-gI
legs	'lEgz
lemon	'lE-m@n
lend	'lEnd
less	'lEs
let	'lEt
let's	'lEts
lets	'lEts
lewi	'lu-I
lewis	'lu-Is
liar	'l2-@R
licking	'lI-kIN
lie	'l2
life	'l2f
lift	'lIft
lifting	'lIf-tIN
lifty	'lIf-tI
light	'l2t
lights	'l2ts
like	'l2k
liked	'l2kt
likes	'l2ks
line	'l2n
lip	'lIp
listen	'lI-sH
little	'lI-tP
lives	'lIvz
locks	'lQks
lonely	'l5n-lI
long	'lQN
longer	'lQN-g@R
look	'lUk
looked	'lUkt
looking	'lU-kIN
looks	'lUks
lorry	'lQ-rI
lost	'lQst
lot	'lQt
lot's	'lQts
lots	'lQts
lou-lou	'lu-lu
love	'lVv
lovely	'lVv-lI
loves	'lVvz
lu	'lu
lucky	'lV-kI
lulu	'lu-lu
lulu's	'lu-luz
lump	'lVmp
lunch	'lVnJ
lunchtime	'lVnJ-t2m
lying	'l2-IN
machine	m@-'Sin
mad	'm{d
madam	'm{-d@m
madame	'm{-d@m
made	'm1d
make	'm1k
makes	'm1ks
making	'm1-kIN
man	'm{n
man-sized	'm{n-s2zd
manage	'm{-nI_
managed	'm{-nI_d
managing	'm{-nI-_IN
many	'mE-nI
margarine	"m#-_@-'rin
mark	'm#k
mat	'm{t
match	'm{J
mates	'm1ts
mats	'm{ts
matter	'm{-t@R
may	'm1
maybe	'm1-bi
me	'mi
meal	'mil
mean	'min
means	'minz
measy	'mi-zI
medium	'mi-dj@m
meringue	m@-'r{N
mess	'mEs
messed	'mEst
messing	'mE-sIN
messy	'mE-sI
microphone	'm2-kr@-f5n
middle	'mI-dP
midwife	'mId-w2f
might	'm2t
mike	'm2k
milk	'mIlk
milky	'mIl-kI
mind	'm2nd
minute	'mI-nIt
minutes	'mI-nIts
miringue	m@-'r{N
misery	'mI-z@-rI
miss	'mIs
missed	'mIst
mix	'mIks
mixing	'mIk-sIN
mm	'm
moan	'm5n
moaning	'm5-nIN
mobile	'm5-b2l
mobile's	'm5-b2lz
moment	'm5-m@nt
monday	'mVn-dI
money	'mV-nI
monkey	'mVN-kI
monkey's	'mVN-kIz
mood	'mud
moose	'mus
mop	'mQp
more	'm$R
morning	'm$-nIN
most	'm5st
mother	'mV-D@R
mouse	'm6s
mouth	'm6T
mouthful	'm6T-fUl
move	'muv
mr	'mI-st@R
much	'mVJ
mucky	'mV-kI
mum	'mVm
mum's	'mVmz
mumma	'mV-m@
mummy	'mV-mI
mummy'll	'mV-mI-@l
mummy's	'mV-mIz
mums	'mVmz
music	'mju-zIk
must	'mVst
my	'm2
myron	'2-r@n
myron's	'2-r@nz
n't	Ht
n'ta	H-t@
nails	'n1lz
nap	'n{p
nappies	'n{-pIz
napps	'n{ps
nappy	'n{-pI
nasty	'n#-stI
natasha	n@-'t#-S@
natasha's	n@-'t#-S@z
natural	'n{-Jr@l
naughty	'n$-tI
near	'n7R
nearly	'n7-lI
neasy	'ni-zI
neck	'nEk
necklace	'nEk-lIs
need	'nid
needs	'nidz
never	'nE-v@R
nevermind	'nE-v@R-'m2nd
new	'nju
newspaper	'njus-"p1-p@R
newspapers	'njus-"p1-p@z
next	'nEkst
nibble	'nI-bP
nice	'n2s
nicely	'n2s-lI
nicer	'n2-s@R
nicky	'nI-kI
night	'n2t
nightnight	'n2t-'n2t
nine	'n2n
no	'n5
nobody's	'n5-b@-dIz
noise	'n4z
noises	'n4-zIz
none	'nVn
normally	'n$-m@-lI
nose	'n5z
nosey	'n5-zI
nosh	'nQS
not	'nQt
nother	'nV-D@R
nothing	'nV-TIN
notice	'n5-tIs
nottingham	'nQ-tIN-@m
now	'n6
nowadays	'n6-@-d1z
nuddy	'nV-dI
nuisance	'nju-sHs
o'clock	@-'klQk
occupied	'Q-kjU-p2d
of	@v
off	'Qf
oggle	'5-gP
oh	'5
oh-oh	'5-'5
oi	'4
oil	'4l
okay	"5-'k1
old	'5ld
on	'Qn
once	'wVns
one	'wVn
one'll	'V-nP
one's	'wVnz
ones	'wVnz
only	'5n-lI
ooh	'u
ooops	'ups
oop	'up
oops	'Ups
oops-a-daisy	"Ups-@-'d1-zI
open	'5-p@n
or	@R
orchestra	'$-kIs-tr@
other	'V-D@R
ought	'$t
ounces	'6n-sIz
our	'6-@R
out	'6t
outside	"6t-'s2d
oven	'V-vH
over	'5-v@R
ow	'6
own	'5n
packet	'p{-kIt
packing	'p{-kIN
paddy	'p{-dI
page	'p1_
painful	'p1n-fUl
pains	'p1nz
pants	'p{nts
paper	'p1-p@R
papers	'p1-p@z
pardon	'p#-dH
parents	'p8-r@nts
parrot	'p{-r@t
parrot's	'p{-r@ts
parrots	'p{-r@ts
past	'p#st
pastry	'p1s-trI
pat	'p{t
pat-a-cake	'p{-tI-'k1k
patch	'p{J
patting	'p{-tIN
paws	'p$z
peace	'pis
peck	'pEk
peculiar	pI-'kju-lj@R
peed	'pid
peeing	'pi-IN
peek-a-boo	'pi-k@-'bu
peek-boo	'pi-'bu
penny	'pE-nI
people	'pi-pP
peoples	'pi-pPz
perch	'p3J
perform	p@-'f$m
performing	p@-'f$-mIN
perhaps	p@-'h{ps
person	'p3-sH
persuade	p@-'sw1d
pet	'pEt
petal	'pE-tP
phew	'fju
phone	'f5n
pick	'pIk
picked	'pIkt
pictures	'pIk-J@z
pie	'p2
pin	'pIn
pinch	'pInJ
pinching	'pIn-JIN
place	'pl1s
plants	'pl#nts
plastic	'pl{-stIk
play	'pl1
playing	'pl1-IN
playmate	'pl1-m1t
plays	'pl1z
please	'pliz
pleased	'plizd
plenty	'plEn-tI
plug	'plVg
point	'p4nt
poke	'p5k
poley	'p5-lI
polly	'pQ-lI
polly'd	'pQ-lId
polly's	'pQ-lIz
pollyleemy	'pQ-lI-'li-mI
pony	'p5-nI
pooh	'phu
poopsie	'pup-sI
poor	'p$R
pop	'pQp
popeye	'pQp-2
poppers	'pQ-p@z
poppit	'pQ-pIt
pops	'pQps
potimus	'pQ-t@-m@s
pots	'pQts
potty	'pQ-tI
pound	'p6nd
pour	'p$R
powder	'p6-d@R
praise	'pr1z
pram	'pr{m
precious	'prE-S@s
pregnant	'prEg-n@nt
present	'prE-zHt
presto	'prE-st5
pretend	prI-'tEnd
pretty	'prI-tI
price	'pr2s
privilege	'prI-vI-lI_
problems	'prQ-bl@mz
prop	'prQp
proper	'prQ-p@R
properly	'prQ-p@-lI
prove	'pruv
proving	'pru-vIN
pudding	'pU-dIN
pull	'pUl
pulling	'pU-lIN
punch	'pVnJ
pup	'pVp
puppet	'pV-pIt
push	'pUS
pushed	'pUSt
puss	'pUs
pussy	'pU-sI
pussycat	'pU-sI-k{t
put	'pUt
putting	'pU-tIN
quack	'kw{k
quick	'kwIk
quiet	'kw2-@t
quite	'kw2t
rabbit	'r{-bIt
radio	'r1-dI-5
rain	'r1n
raining	'r1-nIN
rarely	'r8-lI
rascal	'r#s-k@l
raspberry	'r#z-b@-rI
rattle	'r{-tP
rattles	'r{-tPz
rattling	'r{-tP-IN
reach	'riJ
read	'rid
reading	'ri-dIN
ready	'rE-dI
real	'r7l
realized	'r7-l2zd
really	'r7-lI
recipe	'rE-sI-pI
reckon	'rE-k@n
record	'rE-k$d
red	'rEd
reflection	rI-'flEk-SH
relax	rI-'l{ks
remember	rI-'mEm-b@R
rest	'rEst
restless	'rEst-lIs
revolting	rI-'v5l-tIN
rewind	'rI-'w2nd
ribbon	'rI-b@n
rich	'rIJ
rid	'rId
right	'r2t
ring	'rIN
rip	'rIp
ripped	'rIpt
roley	'r5-lI
roll	'r5l
rolling	'r5-lIN
romans	'r5-m@nz
roof	'ruf
room	'rum
rotten	'rQ-tH
rough	'rVf
round	'r6nd
rub	'rVb
rubbers	'rV-b@z
rubbing	'rV-bIN
rude	'rud
rug	'rVg
rules	'rulz
rumbling	'rVm-blIN
runs	'rVnz
rusk	'rVsk
rusky	'rVs-kI
sack	's{k
sackcloth	's{k-klQT
sad	's{d
said	'sEd
salad	's{-l@d
same	's1m
sang	's{N
satisfy	's{-tIs-f2
saturday	's{-t@-dI
saucepan	's$s-p@n
sausage	'sQ-sI_
saw	's$
say	's1
saying	's1-IN
says	's1z
scalp	'sk{lp
school	'skul
scream	'skrim
screaming	'skri-mIN
screwing	'skru-IN
scruffs	'skrVfs
sea	'si
seaside	'si-s2d
seatbelt	'sit-'bElt
second	'sE-k@nd
seconds	'sE-k@ndz
see	'si
seef	'sif
seeing	'si-IN
seen	'sin
self	'sElf
sell	'sEl
send	'sEnd
sending	'sEn-dIN
sent	'sEnt
serious	's7-r7s
servants	's3-v@nts
sew	's5
sewing	's5-IN
sh	S
shake	'S1k
shakes	'S1ks
shaking	'S1-kIN
shall	'S{l
shame	'S1m
shan't	'S#nt
sharp	'S#p
shawl	'S$l
she	'Si
she'll	'Sil
she's	'Siz
sheets	'Sits
shining	'S2-nIN
shirt	'S3t
shirts	'S3ts
shoes	'Suz
shoo	'Su
shoot	'Sut
shooting	'Su-tIN
should	'SUd
shoulder	'S5l-d@R
shouldn't	'SU-dHt
shout	'S6t
shouter	'S6-t@R
shouting	'S6-tIN
show	'S5
showing	'S5-IN
shrew	'Sru
shunting	'SVn-tIN
shush	'SUS
shut	'SVt
shy	'S2
sick	'sIk
sickly	'sIk-lI
sicky	'sI-kI
side	's2d
sides	's2dz
sigh	's2
silent	's2-l@nt
silly	'sI-lI
sing	'sIN
sister	'sI-st@R
sit	'sIt
sitting	'sI-tIN
sixteen	"sIks-'tin
size	's2z
sized	's2zd
skirt	'sk3t
sky	'sk2
sleep	'slip
sleeping	'sli-pIN
sleepy	'sli-pI
slept	'slEpt
slid	'slId
slide	'sl2d
slightest	'sl2-tIst
slip	'slIp
slipping	'slI-pIN
sloppy	'slQ-pI
slow	'sl5
smacking	'sm{-kIN
smell	'smEl
smelly	'smE-lI
smile	'sm2l
smiles	'sm2lz
smiling	'sm2-lIN
smurf	'sm3f
snails	'sn1lz
sneeze	'sniz
sneezies	'sni-zI
sneezing	'sni-zIN
snooze	'snuz
snoozing	'snu-zIN
snorting	'sn$-tIN
snorty	'sn$-tI
so	's5
so's	's5z
soaked	's5kt
soaking	's5-kIN
soap	's5p
soapy	's5-pI
sober	's5-b@R
sock	'sQk
socks	'sQks
soft	'sQft
soiled	's4ld
solids	'sQ-lIdz
somat	's5-mQt
somat's	's5-mQts
some	s@m
somebody	'sVm-b@-dI
someone	'sVm-wVn
something	'sVm-TIN
somewhere	'sVm-w8R
song	'sQN
soon	'sun
sore	's$R
sorry	'sQ-rI
soul	's5l
sound	's6nd
sounds	's6ndz
spin	'spIn
spinach	'spI-nI_
spit	'spIt
splash	'spl{S
splashing	'spl{-SIN
splish	'splIS
splosh	'splQS
sponge	'spVn_
sponser	'spQn-s@R
sports	'sp$ts
spuddies	'spV-dIz
spuds	'spVdz
squeaky	'skwi-kI
squeeze	'skwiz
squiggly	'skwI-gP-I
stairs	'st8z
stand	'st{nd
standing	'st{n-dIN
stands	'st{ndz
star	'st#R
staring	'st8-rIN
start	'st#t
starts	'st#ts
starved	'st#vd
stay	'st1
staying	'st1-IN
steak	'st1k
stern	'st3n
steve	'stiv
stew	'stju
stick	'stIk
sticking	'stI-kIN
sticks	'stIks
stiff	'stIf
still	'stIl
stockport	'stQk-p$t
stomach	'stV-m@k
stone	'st5n
stop	'stQp
stopped	'stQpt
stories	'st$-rIz
story	'st$-rI
straight	'str1t
straighten	'str1-tH
strangle	'str{N-gP
strawberry	'str$-b@-rI
stretch	'strEJ
stretching	'strE-JIN
striped	'str2pt
strong	'strQN
struggle	'strV-gP
struggling	'strV-glIN
stuck	'stVk
stuff	'stVf
stupid	'stju-pId
substantial	s@b-'st{n-SP
such	'sVJ
suck	'sVk
sucked	'sVkt
suckin'	'sV-kIn
sucking	'sV-kIN
suds	'sVdz
suit	'sut
sun	'sVn
sunbathe	'sVn-b1D
sunhat	'sVn-'h{t
sunlight	'sVn-l2t
sunshine	'sVn-S2n
supper	'sV-p@R
suppose	s@-'p5z
supposed	s@-'p5zd
suprise	s@-'pr2z
sure	'S$R
surely	'S$-lI
surprise	s@-'pr2z
swallow	'swQ-l5
swan	'swQn
swearing	'sw8-rIN
sweater's	'swE-t@z
sweatheart	'swit-h#t
sweeper	'swi-p@R
sweepers	'swi-p@z
sweeps	'swips
sweepy	'swi-pI
sweet	'swit
sweetheart	'swit-h#t
sweetie	'swi-tI
sweetpea	'swit-pI
swim	'swIm
swimming	'swI-mIN
swing	'swIN
swinging	'swI-NIN
sylvester	sil-'vE-st@R
system	'sI-st@m
t'ave	't{v
t-shirt	'ti-'S3t
ta	't#
ta-ta's	't#-'t#
tail	't1l
take	't1k
taken	't1-k@n
takes	't1ks
taking	't1-kIN
talc	't{lk
tale	't1l
tales	't1lz
talk	't$k
talking	't$-kIN
tape	't1p
taste	't1st
tastes	't1sts
tasting	't1-stIN
tasty	't1-stI
tea	'ti
tea-time	'ti-t2m
teach	'tiJ
teaches	'ti-JIz
teaching	'ti-JIN
teapot	'ti-pQt
tears	't7z
teasing	'ti-zIN
ted	'tEd
teddy	'tE-dI
teddy's	'tE-dIz
teeth	'tiT
teething	'ti-DIN
teggypegs	'tE-dI-pEgz
telephone	'tE-lI-f5n
television	'tE-lI-"vI-ZH
tell	'tEl
telling	'tE-lIN
telly	'tE-lI
temper	'tEm-p@R
tempered	'tEm-p@d
ten	'tEn
tennis	'tE-nIs
terrible	'tE-r@-bP
terribly	'tE-r@-blI
than	D@n
thank	'T{Nk
that	'D{t
that'll	'D{-tP
that's	'D{ts
thats	'D{ts
the	D@
their	'D8
them	'DEm
then	'DEn
there	'D8R
there's	'D8z
theres	'D8z
these	'Diz
they	'D1
they'd	'D1d
they'll	'D1-@l
they're	'D1-@R
they've	'D1v
thicker	'TI-k@R
thing	'TIN
things	'TINz
think	'TINk
thinking	'TIN-kIN
thinks	'TINks
third	'T3d
thirsty	'T3-stI
this	'DIs
thomas	'tQ-m@s
those	'D5z
though	'D5
thought	'T$t
three	'Tri
throat	'Tr5t
through	'Tru
throw	'Tr5
throwing	'Tr5-IN
thu	'TV
thumb	'TVm
thumbs	'TVmz
thunder	'TVn-d@R
tickle	'tI-kP
tickles	'tI-kPz
tickling	'tI-klIN
ticklish	'tI-kP-IS
tickly	'tIk-lI
tickly-poo	'tIk-lI-'pu
ticks	'tIks
ticky	'tI-kI
tiddley	'tId-lI
tied	't2d
tight	't2t
till	'tIl
time	't2m
tin	'tIn
tiny	't2-nI
tired	't2-@d
tiredy	't2-@-dI
tis	'tIz
tissue	'tI-Su
tit	'tIt
tits	'tIts
to	t@
today	t@-'d1
toe	't5
toenails	't5-n1lz
toes	't5z
together	t@-'gE-D@R
told	't5ld
tomorrow	t@-'mQ-r5
tongue	'tVN
tonight	t@-'n2t
tons	'tVnz
too	'tu
took	'tUk
toot	'tut
tooth	'tuT
toothie's	'tu-Tiz
top	'tQp
tossles	'tQ-s@lz
touch	'tVJ
touching	'tV-JIN
tour	't9R
towel	't6-@l
toy	't4
toys	't4z
trai	'tr1
treasure	'trE-Z@R
treasuroooo	'trE-Z@-'ru
treazh	'trEZ
tree	'tri
trim	'trIm
trouble	'trV-bP
true	'tru
try	'tr2
trying	'tr2-IN
tub	'tVb
tuba	'tju-b@
tubby	'tV-bI
tuesday	'tjuz-dI
tum	'tVm
tumma	'tV-m@
tummy	'tV-mI
tummy'll	'tV-mI-@l
turn	't3n
turned	't3nd
turning	't3-nIN
tv	'ti-'vi
twelve	'twElv
twice	'tw2s
twist	'twIst
two	'tu
type	't2p
typical	'tI-pI-kP
ugh	'Vx
uh	'V
uh-hmm	'V-h@m
uh-huh	V-'hV
uncle	'VN-kP
unconsolable	'In-k@n-'s5-l@-bP
under	'Vn-d@R
underneath	"Vn-d@-'niT
underskirt	'Vn-d@R-'sk3t
undress	"Vn-'drEs
unhappy	Vn-'h{-pI
unintelligible	'Vn-In-'tE-lI-_@-bP
unsettled	"Vn-'sE-tPd
until	@n-'tIl
up	'Vp
ups	'Vps
ups-a-daisy	'Vps-@-'d1-zI
upset	Vp-'sEt
upside	'Vp-s2d
upstairs	"Vp-'st8z
us	'Vs
use	'jus
usually	'ju-Z@-lI
very	'vE-rI
vest	'vEst
vesty	'vE-stI
viking	'v2-kIN
vikings	'v2-kINz
violent	'v2-@-l@nt
visitors	'vI-zI-t@z
wages	'w1-_Iz
wait	'w1t
waiting	'w1-tIN
wake	'w1k
waking	'w1-kIN
walk	'w$k
walkies	'w$-kIz
walks	'w$ks
want	'wQnt
wanted	'wQn-tId
wanting	'wQn-tIN
wants	'wQnts
warm	'w$m
warning	'w$-nIN
was	w@z
wash	'wQS
washed	'wQSt
washing	'wQ-SIN
wasn't	'wQ-zHt
watch	'wQJ
watched	'wQJt
watching	'wQ-JIN
water	'w$-t@R
wave	'w1v
waving	'w1-vIN
way	'w1
ways	'w1z
we	'wi
we'd	'wid
we'll	'wil
we're	'w7R
we've	'wiv
wear	'w8R
weather	'wE-D@R
wednesday	'wEnz-dI
wee	'wi
weeks	'wiks
weewee	'wi-wi
weigh	'w1
weighed	'w1d
well	'wEl
went	'wEnt
were	'w3R
weren't	'w3nt
wet	'wEt
what	'wQt
what'll	'wQ-tP
what're	'wQ-t@R
what's	'wQts
what've	'wQ-t@v
when	'wEn
where	'w8R
where're	'w8-r@R
where's	'w8z
where've	'w8-r@v
whether	'wE-D@R
whey	'w1
which	'wIJ
while	'w2l
whiner	'w2-n@R
whites	'w2ts
whiz	'wIz
who	'hu
who're	'huR
who's	'huz
whoa	'w5
whole	'h5l
whoo	'hu
whoop	'wup
whoops	'wups
whoops-a-daisy	'wups-@-'d1-zI
whoopsie	'wup-sI
whos	'huz
whose	'huz
why	'w2
whyn't	'w2nt
wicked	'wI-kId
widdle	'wI-dP
wide	'w2d
wiggler	'wI-gP-@R
will	'wIl
win	'wIn
wind	'wInd
wind's	'w2ndz
windies	'wIn-dIz
window	'wIn-d5
windows	'wIn-d5z
windy	'wIn-dI
wings	'wINz
winking	'wIN-kIN
wipe	'w2p
wiped	'w2pt
wire	'w2-@R
wise	'w2z
wish	'wIS
with	'wID
without	wI-'D6t
wobble	'wQ-bP
woke	'w5k
woken	'w5-k@n
won't	'w5nt
wonder	'wVn-d@R
wondering	'wVn-d@-rIN
work	'w3k
working	'w3-kIN
works	'w3ks
world	'w3ld
worried	'wV-rId
worry	'wV-rI
worst	'w3st
worth	'w3T
wotsiting	'wQt-sI-tIN
would	'wUd
wouldn't	'wU-dHt
wrap	'r{p
wrestle	'rE-sP
wrestling	'rE-slIN
wriggler	'rI-gP-@R
wrong	'rQN
ya	j@
yawn	'j$n
yeah	'j8
years	'j7z
yellow	'jE-l5
yes	'jEs
yesterday	'jE-st@-dI
yet	'jEt
you	'ju
you'd	'jud
you'll	'jul
you're	'j9R
you've	'juv
young	'jVN
your	'j$R
yours	'j$z
yourself	j$-'sElf
yum	'jVm
zee	'zi
zunc	'zVNk
shh	S
ssh	S
mummie	'mV-mI
mummie's	'mV-mIz
mummmy's	'mV-mIz
mummie'll	'mV-mI-@l
tellie	'tE-lI
handie	'h{n-dI
pottie	'pQ-tI
bathie	'b#-TI
ruskie	'rVs-kI
headie	'hE-dI
chinnie	'JI-nI
hankie	'h{N-kI
nappie	'n{-pI
drinkie	'drIN-kI
rolly	'r5-lI
rollie	'r5-lI
polly	'p5-lI
pollie	'p5-lI
deary	'd7-rI
hiccough	'hI-kVp
hiccoughs	'hI-kVps
poo	'phu
lew	'lu
&hmm	'hF
&er	'3
&eh	'1
&ha	'h#
&mm	'm
&ah	'#
&uh	'V
&hah	'h#
whee	'wi
treas	'trEZ
hee	'hi
oo	'u
